one	eins
two	zwei
three	drei
four	vier
five	f√ºnf
six	sechs
seven	sieben
eight	acht
nine	neun
ten	zehn
mother	Mutter
father	Vatter
sister	Schwester
brother	Bruder
Monday	Montag
Tuesday	Dienstag
Wednesday	Mittwoch
Thursday	Donnerstag
Friday	Frietag
Saturday	Samstag
Sunday	Sonntag
frog	Frosch
curious	kurios
comical	komisch
consequent	konsequent
